11111111111111111111111111111111111111111111111
100001111111111000000001100001111111111111110E1
10000000000010000000100110000000100000000000001
1000000001001000110011C111111110000000000000001
100C0000010010001100111100000011100000100101001
100000000100000000001111000000000000C011C010001
10000011111011100000111101000011100000010010001
1000000C00001111000011C101000001110000000010001
10001111111110000000100001000000000010000010001
100011111111100000001011C10000010011100C0000001
100011111111100000001011110010110001000000000C1
100000000000000000001011C0000001000000000000111
1P00C0001111111110000C1100000000000C0001000C101
11111111111111111111111111111111111111111111111
